####################/
####################/
####################/
####################/
####################/
####################/
####################/
####vvvvvvvv==vvvvvv/
vvvv~~~~~~~~==~~~~~~/
~~~~~~~~~~~~==~~~~~~/
~~~~~~~~~~~~==~~~~~~/
~~~~~~~~~vvv==vvv~~~/
~~~~vvvvv########vvv/
vvvv################/
####################/
####################/
####################/
####################/
####################/
####################/
